1,1,1,1,1,1,1,1,1,1
1,131,130,100,101,110,111,112,0,1
1,0,0,0,0,0,0,0,0,1
1,40,120,1,123,80,1,20,60,1
1,41,121,1,124,81,1,21,61,1
1,42,122,1,125,82,1,22,62,1
1,50,0,0,0,0,0,0,63,1
1,51,30,1,90,10,1,13,64,1
1,52,31,1,91,11,1,14,65,1
1,53,32,1,92,12,1,15,0,1
1,54,0,0,0,0,0,0,2,1
1,1,1,1,1,5,1,5,0,1
1,1,1,1,1,1,1,1,0,1
1,1,1,1,1,1,1,1,1,1
